###################
###################
###################
###################
###################
###################
#### ####### ######
###  #######  #####
###  #######  #####
###  ### ###  #####
#### #  #  # ######
#### #  #  # ######
####         ######
###           #####
###           #####
#######   #########
####  #   #  ######
####         ######
#######   #########
#######   #########
#######   #########
#######   #########
#######   #########
#######   #########
#######   #########
#######   #########
#######   #########
#######   #########
#######   #########
#######   #########
#######   #########
#######   #########
#######   #########
#######   #########
#######   #########
#######   #########
#######   #########
#######   #########
#######SSS#########
###################
###################
###################
###################
###################
###################
###################
###################
