############################
############################
############################
############################
## ### ############# ### ###
##     #############     ###
#       ###########       ##
#       ###########       ##
#       ###########       ##
## # # ############# # # ###
#### #### ##   ## #### #####
#### ####         #### #####
#### #### ####### #### #####
#### ##   #######   ## #####
###     ###########     ####
###   # ########### #   ####
###   # ########### #   ####
###   # ########### #   ####
###   # ########### #   ####
#### ## ########### ## #####
#### #######   ####### #####
#### ####         #### #####
#### ####         #### #####
## # # ##  #   #  ## # # ###
##      #  #   #  #      ###
#       #         #       ##
#                         ##
#       #         #       ##
#       #         #       ##
##     ###       ###     ###
############   #############
############   #############
############   #############
############   #############
############   #############
############   #############
############   #############
############   #############
############   #############
############SSS#############
############################
