##################################
##################################
###############   ################
###############   ################
###############   ################
###############   ################
###############   ################
###############   ################
###############   ################
###############   ################
###############   ################
###############   ################
###############   ################
###############   ################
###############   ################
######   ######   ################
####### ######     ###############
####### #####   #   ## ##  ## ####
#              ###              ##
#              ###              ##
#  ##########  ###     ######## ##
#############       ##############
##############     ###############
###############   ################
###############   ################
###############   ################
###############   ################
###############   ################
###############   ################
###############   ################
###############   ################
###############   ################
###############   ################
###############   ################
###############   ################
###############   ################
###############   ################
###############SSS################
##################################
##################################
